++++++++++++
{----------}
$........../
$........../
$........../
$.P......../
$........../
[__________]